**X***XXXX******X****X***
X**XX**XX**X*X*XX*XX***X*
*X*X*X****XX*X******X*X**
*X****XX*X***XXX*XXXX**X*
**XXX*X***X*X***X****X*X*
*XX*X**XX**X**X***XX***X*
*****X***XXX*XXXXX**XX*X*
*XX*XXX*X*****X***X***X**
*X***XX***XXXX**X**X*XX*X
*X*X***X*X*****XXX***X**X
**X**X**X**XX*X*XXX*X**X*
X*X*X*XX**X**X***X**X*X**
X*X*X****X*X***X*X*X**X*X
***X**X*XX***XX*****X*X**
*X*X*X**X**X***XX*X*X*XX*
*X*X*X*X**X*XX***X*X***X*
*XXX*X**XX***X*XX****XX**
******X***XX****X*X*X***X
*XXXXX*XX***X*X*X**XXX*X*
*******XXXX**X*X*X**X****
XXXX*X**X*X*X*****X***XX*
****X*X***X*X*X*XX*XXX***
*X*X***X*X**X*X******X*XX
**XX*X***X*X***XX*XXXX*X*
X*****X*X****X**X********
